SO ./imgs/NO.xpm
WE ./imgs/NO.xpm
EA ./imgs/NO.xpm
NO ./imgs/NO.xpm

F 0,0,0
C 224,185,67


1111
10N1
1111