SO ./imgs/NO.xpm
WE ./imgs/NO.xpm
EA ./imgs/NO.xpm
NO ./imgs/NO.xpm

F 0,0,0
C 224,185,67



111
101
100
10S01
11111